37 19
mazes_data/11.txt
5
h 10 8
h 2 1
c 16 1
c 4 2
c 4 3
0
17 1
5 2
1111111111111111111111111111111111111
1000000000001000000000000000000000001
1000100011111000111110001111111110001
1000100000000000100010001000000000001
1000111111111000100010001000111111111
1000100000001000100010001000000000001
1111100010001000100010001111111110001
1000000010001000100010001000000000001
1000111110001000100010001111111110001
1000100010001000100010001000000010001
1000100010001000100010001000100010001
1000100000001000000010000000100010001
1000100011111111100011111111100010001
1000100000000000100000000000100010001
1000111111111000111111111000100011111
1000100000001000100000000000100000001
1000100010001000111111111111111110001
1000000010001000000000000000000000001
1111111111111111111111111111111111111