41 21
mazes_data/12.txt
0
1
e 13 38
8 18
19 19
11111111111111111111111111111111111111111
10000000100000000000000010000000000000001
10001111100011111000100011111111111110001
10000000100010001000100010000000000010001
10001000100010001000100010001111100010001
10001000100010001000100000001000100000001
10001000100010001000111111111000100011111
10001000000000001000100000000000100010S01
10001111111111111000111110001000100010001
10001000000000001000000010001000000010001
10001000111110001111100010001111111110001
10001000100000000000000010001000000000001
10001000111111111111111110001000111111111
10001000000000000000100000001000000010001
10001111111111111000111111111111100010001
10000000100000000000100000001000000010001
11111000100011111111100010001000111110001
10000000100010000000000010001000100000001
10001111100010001111111110001000100010001
10000000100000000000000010000000000010001
11111111111111111111111111111111111111111