45 23
mazes_data/13.txt
1
h 1 34
4
e 9 39
t 5 42
e 19 38
d 18 6
9 26
18 15
111111111111111111111111111111111111111111111
100000001000000000000000000010000000000000001
100010001000111111111111100010001111111110001
100010001000100010000000000010001000000000001
100011111100100010001000111111001000111111001
100000000000000010001000100000001000000010001
100011111111111111001111100111111111110011111
100010001000000000001000000000000000100000001
100010001000111111111100111111111100111111001
100000001000100000000000100000001000000010001
111111111000100011111111111111001111111111001
100000000000100000001000000010000000000010001
100011111111111111001000100011111111110010001
100000000000000000001000100010000000100010001
100011111111111111111100100010001000100010001
100000001000000000000000100000001000100010001
111111001000100010001111111111001111110010001
100010001000100010001000000010001000000010001
100010001111110010001000100011111100111110001
100010000000100010001000100000000000100000001
100011111100100010001000111111111111111111001
100000000000000010001000000000000000000000001
111111111111111111111111111111111111111111111
