57 29
mazes_data/15.txt
6
r 4 10
r 1 22
r 12 12
q 18 28
h 23 3
c 2 21
2
d 17 29
f 1 25
17 28
1 26
111111111111111111111111111111111111111111111111111111111
100000001000000000001000000000000000000000000000000010001
100010001000111111111000111111111111100011111111100010001
100010001000000000000000000010000000100000001000100010001
100010001000111111111111100011111000111110001000100010001
100010001000100000000000100010000000100000001000100010001
100010001111100011111000100010001000100011111000100010001
100010001000000010001000100000001000100010000000000010001
100010001000111110001000111111111000100011111000111110001
100010000000100000001000100000000000100000001000000000001
100011111111100011111000111110001111111110001111111110001
100000001000000000001000000010000000100000001000000010001
111110001000111110001111100011111000100011111000100010001
100000001000000010000000100010000000100000000000100010001
100011111111100011111000100010001111111111111111100010001
10000000000010001000000010S010001000000000000000100010001
111111111000100010001111111111111000111111111000100010001
100000001000100010000000000000001000000000001000000010001
111110001000111110001111100010001111111110001111111110001
100000001000000010000000100010001000000000001000100000001
100011111111100010001111100010001000111111111000100011111
100000000000000010001000000010000000100000000000100010001
100011111111111111111000111111111111100010001111100010001
100010000000100000000000100000001000000010001000000010001
100010001000100011111111100010001111100011111000111110001
100010001000100000000000000010000000100000000000100000001
100010001000111111111111111111111000100011111111111110001
100000001000000000000000000000000000100000000000000000001
111111111111111111111111111111111111111111111111111111111