81 41
END_DIR
12
c 33 63
c 7 27
c 33 33
c 36 51
q 27 29
q 20 54
q 23 50
q 39 42
r 15 42
r 20 77
h 37 33
h 39 67
12
t 35 70
d 29 39
e 32 63
f 24 58
h 18 63
r 25 35
t 33 46
d 35 75
e 27 30
f 39 65
h 32 66
r 21 63
39 34
35 73
111111111111111111111111111111111111111111111111111111111111111111111111111111111
100010000000000000001000000000000000000000001000000000000000000000000000000000001
100010001111111110001000111111111000111110001111111111111111111111111000111110001
100000000000000010000000000000001000000010001000000010000000000000000000100000001
100011111111100011111111100011111111100010001000100010001111111111111111100011111
100010000000100010000000100010000000000010001000100000001000000010000000100010001
100010001000111110001000111110001111111110001000111111111000100010001000100010001
100010001000000000001000000010000000100010001000000010000000100000001000100000001
100010001111111111111111100011111000100010001111100010001000111110001111111110001
100010000000000010000000100000000000100010000000100010001000100000001000000010001
100011111111100010001000111111111111100011111000100011111000111110001000100010001
100000000000100010001000000010000000000000000000100000001000000010001000100000001
111110001111100010001000111110001111111111111111111110001000100011111000111111111
100000001000000010001000000000001000000000001000000010001000100000000000100000001
100011111000111111111111100011111111100010001000100010001000111111111111111110001
100010001000000000000000100000000000000010001000100000001000000010000000000010001
100010001111111111111000111111111111111110001000111111111111100010001111100010001
100000001000000010000000100000001000000010001000100000000000100010000000100000001
111110001000100010001111100010001000100010001000111111111000100010001000111110001
100010001000100010000000100010000000100010001000000000001000100010001000100010001
100010001000100011111000111110001111100010001111111110001000100011111000100010001
100010001000100000001000000010000000100000000000000000001000000000000000100000001
100010001111111110001111100011111111111111111111111111111111111111111111100011111
100010000000100000000000100010000000000000000000000000000000100000000000000000001
100011111000100011111000100010001111111111111111111111111000111111111111111110001
100000001000100010001000100010001000000000001000000000001000000000000000100010001
100010001000100010001000100010001000111110001000100011111111111111111000100010001
100010001000000010000000100000001000100010000000100000000000000010000000100010001
100011111111111110001111111111111000100011111111111111111000100010001111100010001
100000000000100000001000000000001000000000000000000010000000100010000000100010001
111111111000100011111000100011111111111110001111111110001000111111111000100010001
100000000000100010000000100000000000000000001000000000001000100000000000100000001
100011111000100011111111111111111000111111111000111111111000100010001111111111111
100010000000100010000000000000001000000010000000100010000000100010001000000000001
100011111000100010001111111110001111111110001111100010001111100011111000111110001
100000001000100010000000100000001000000000001000000000000000100010000000000010001
100010001111100011111000100011111000100011111111100011111111100010001111111110001
100010001000000010000000100010000000100010000000100010000000100000001000000010001
100010001000111110001111100010001111111110001000111110001000111111111000100010001
100010000000000000001000000000001000000000001000000000001000000000000000100000001
111111111111111111111111111111111111111111111111111111111111111111111111111111111