13 7
mazes_data/3.txt
0
0
1 6
5 10
1111111111111
1000000000001
1000111110001
1000100010001
1000100010001
1000000010001
1111111111111