13 7
mazes_data/4.txt
0
0
1 2
5 2
1111111111111
1000000000001
1111111110001
1000000010001
1000100010001
1101100000001
1111111111111