17 9
mazes_data/5.txt
0
0
3 6
7 2
11111111111111111
10000000000000001
10001111100010001
10001000100010001
10001000111110001
10001000100000001
10001000100010001
10001000000010001
11111111111111111