21 11
mazes_data/6.txt
0
1
t 5 6
2 19
9 7
111111111111111111111
100000000000000000001
100011111111111111001
100000001000100000001
100010001000100011111
100010001000000000001
100010001111111111111
100010000000000000001
100011111111111110001
100000000000000111011
111111111111111111111