21 11
mazes_data/7.txt
0
0
9 5
1 19
111111111111111111111
100000000000100000001
100011111000111111001
100010000000000000001
100011111111111111111
100000000000000000001
100011111111100010001
100010000000100010001
100010001000111110001
100010110000000000011
111111111111111111111