29 15
mazes_data/8.txt
0
1
r 13 26
9 10
3 18
11111111111111111111111111111
10000000000000000000000000001
10001111111111111111100011001
100010000000000000E0100010001
10001000111111111111100011111
10000000100000000000100000001
11111000100011111000110011001
10001000110110000000100010001
10001000100010001111111110011
10000000110110001000000000001
10001111110110001000111111111
10001000000010000000100000001
10001111100011111111100011011
10000000000000000000000010001
11111111111111111111111111111
