29 15
mazes_data/9.txt
2
c 9 23
c 10 18
0
1 12
8 23
11111111111111111111111111111
10000000000000000000000010001
10001000111111111111111110001
10001000100000001000000000001
10001111100111001000111111111
10000000000010001000000000001
10001111111110001111111110001
10001000100000000000100000001
10001000100010001111100010111
10001000100010001000000010001
10001000100011111000111110001
10000000100000001000000010001
11111000111110001111100010001
10000000000010000000000000001
11111111111111111111111111111