33 17
mazes_data/10.txt
0
1
d 11 14
11 6
3 6
111111111111111111111111111111111
100000000000100000000000100000001
100011111000111111111000100010001
100010001000000010000000100010001
100010001111100010001000100010001
100000000000100010001000100010001
100011111111100010001111100010001
100010000000000010000000000010001
100010001111111111111111111110001
100010001000000000001000000000001
100010001000111110001001111111111
100010001000100000001000000000001
100011111000111110001111111110001
100010000000000010000000000010001
100011111111100011111111100010001
100000000000000010000000000000001
111111111111111111111111111111111
